1S1111
101001
101011
100001
110101
1111E1